W   W   WWWW  W    W      WW
W   W   W     W    W     W  W
WWWWW   WWW   W    W     W  W
W   W   W     W    W     W  W
W   W   WWWW  WWW  WWW    WW
