WWWWWWWWWWWWWWWWWWWWWWWWWWWWW
W                           W
W                           W
W                           W
W                           W
W                           W
W                           W
W                           W
W                           W
WWWW        WWWWWWWWWWWWWWWWW
   W        W
   W        W
   W        W
   W        W
   WWWWWWWWWW
