WWWWWWWWWW
W        W
W        W
WWWWWWWWWW


WWWW   WWWWWWWW
W             W
W             W
W             W
W             W
WWWWWWWWWWWWWWW

W     W   WWWWWW    W 
W     W   W         W
WWWWWWW   WWW       W
W     W   W         W
W     W   WWWWWW    W